**X******X******X***XX*X********X***XX******X**X*****X******X***********X*X*X*****X******X**********
X*X*X*X*X**XX*X*X*X****X*X*X*XX**X*X***XXXX******X*X**X*XX*X**X*XX*XXX*X*****X*X*X**X*X*X**X*X*XX*X*
X**X**X*X***X*X*X**X*XXX**XX*X*X***X*XXX***XX***X**XX*XXX**X*X****X***X**XXX***X***X***X**XX*X***X**
**X**X****X*X*XXXX*******X***X**X*XX****XX***XXX**X*X*****XX**X*X*X*X*X*X***X*XX*X*XXXX**XX***XXX**X
*X*X****X***X*******XXXXX**XX*X*****XXX**X*X*X***X**XX*X*X***X**X*X*X***X*X***X***X*****XX**XX****X*
*X***XX***X*XXX**XX*X***X*XXX***X*XX***X****X**XX*X*****XX*XX**XXX**XXX*X**XXX**XX**XXXXX**XX**XX***
*XXX*X**XXX****X**X***X*X*XX**XX*X***XX*XX*X**XXX***XXXX***X**X*X**X***X*X***XXX*X*X*****X*X**X**XX*
****X**X*X*XX*X*X**X*XX*X***X****X*X*******X*XXX**XX*****XX*X***X*X**XX***XX*****X*X*X*X**X**X*X**X*
XXX*XX******X***X*X*X***X*X**XX*XX**XX*XXXXX**X**X*X*XX*X***X*X*X**X****X**XXX*X*X*X**X*X**X*X***XX*
**X**X*X*XX**XX*X****X***X*X*X****X***X*****X**XX****X*XX*XX**XX*X*X*X*X**X***X**X*XX****X***XX*X***
*X****X**X**X****X*X***X***X*X*XX**XX**X*XX**X**X*XXX*****XX*X***X*X*X**XX****X*XX***XX*XXXXX*X*X*XX
****X**X**X***XXX*X*XX***XX**XX**X***X**XX**XX*X**X*X*XX*X***X*X*X**X**X***X****X*XX*X**XX******X***
*X*X**X*X**X*X******X**XX***X***X***XXX****X***X**X*X*X**X*XX**X**X***X**X*XXXXX***X*X*X***X*XX**XX*
**X**X***X*X**X*XXX**XX*X*X***X***X**XX*X*XX*X**X*****X*XX****X*X**XX*X*X*X******X*X*X*XXX*X**X*X*X*
X***X*X*X***X******X****X***X**XXXXX*****X***X*X**X*X*X*X*XXXXX**X****X***X*XXX*X*X**X****XXX**X****
**XX****XX*X**X*X*X*XXX**XX**X*X**X*XX*X*X*X**X**X****X***X*****X*XXXX*XX***X*X***X*X*XXX**XXX***X*X
*XX*XX*X***XX**X**X*X***X**X*****X****X**X**X*X*XXX*XX**X*X*X*X******X***X*X**X*XXX*X****X**X**XXXX*
*****X***X***X*X*X***XX***X*X*X*X**XX**X*X*X*X**XX**X**X**X*X**XX**X***X*****X**X***XX*X**X**X***X**
XXXX*X*XX**X**X****X***XX***X**X**X*XX*X***X***X***X**XXX*X*XX*X*X**X*X**X**X**X**XX***X*X*X**XX***X
***X*****X***XX*X***XX**X*X**XX***X****XXX*X*X*X*XX**XXX**XX***X***X*X**XX*X**X**XX*****X***X*X**X**
XX**XX*X**X*****XXXXX*X****XX***XX**XXX****X*XX***X*XXX**X***XX*X*X****XX**X*X**X***XX*X**X*X**XX*X*
***X*X*X*X**X*XX******X*XX**X*XX***X***X*X*X***XXX***X**XXX*XX****X*X*X***XX***X**XX*****X***X***X**
*XX***X**X*X*X***XX*X*XX**X*X**X*XX*X*X***XXXX****XX**X**X****X*X*X**XX*X*X*XX**X*X**XXX**XXXXXX*X*X
**X*X**X*X***X*XX***X***X**X**X**X****X*X**X****X*XXX**X**XXX**X**XX****X*X***X***X*X***XX***X***X*X
X****X*X**X*X**X*X***XX*X*XX*X**X**XX*X**X***X*XX**X*X**X****X**X**X*XXX***XX**X***X**X*X**X***XXX**
X*XX*X*XX*****X**XX*X*X*X****XX**X*X****X*XX*****X****X*X*XX*XX**X**X***XX**XX***XX**XX**X**XXX***X*
**X*XX****X**X**X***X****XX*X***X***XXXXX***XXXX***X*X***X*X****X*X***X***X***X*X***X**X***X****X**X
X*X***X*XX**X**X**X*X*XXX***X*XX**X*******X*X***XXX****X****XX*X***X*X*XX*XXX****X*XXX**X*X**XXX*X**
**XXX**X***X**X**X**X*X***XX**X*XX*X*XXXXX***XX*X*X**X*X*XX***X**X***X******X*XX*X**X**X**X*X****X*X
X****X*X*X*XX*X*X*X***XX*XX*X******XX****XXX**X****X***X**X*X***X*XXX**XXXX**X*X**X**X*X*XX**XXX*X**
*XXX*X*X*X**X***X**XXX***X***XXX*X****XX****X**XXX**X*X*X*X**X*X*****XXX***X****X*X*X**X*X*X******X*
***X*X****X*X*X**X****XX*X*XX***X*XX*X**XXX**X****X***X***XX*X*X*XXX*****X**XX*X**X**X******XXXX*X**
*XX***X*XX***X*X**X*X**X*X****X*X***X*X*****XXXX*XX*X**X*X**X**X****XXXXX*X***X**X*X****XX*X***X*X*X
****XX**X**XX**X*X***X***XXX*X**X*X***X*XX*X*X*X***X**X**XX***X*XXX*X*******XX**X***X**X*X***X*X*X**
*XXX***X**X***X**X*XX*X*X****XX***X*XXX*X*X*****XX**X*X*X*****X***X*X*XX*X*X***X*X*X**X***XXX**X*X**
****X*X**X*X*X*X*X********X*X**XX**X****X***XX*X**X*X*X*X*XX*X**X***X***XXX**XX****X*X**X****XXX**X*
XXX*X*X*XX***X*X*XXXX*X**X***X***X*X*X*X**X**X*X*XX**X**X*****X**XXXXXX**X**X*XXX*X**X*X*X*X*****X**
**X**XX*X**X***X******X*X**XXX*X*X*X**X***XX*X***X*****X*XX*X**X****X**X***XX*****X*XX***X**XXXXX**X
X***X***X***X*X*XXXXXX****X***X*****X*X*XXX*X*XX***XX*X*****X*X*XXX*X*X*XX*X**X*X*X****X***X****X*X*
**XX**XX*X****X******XX*X*X*X*XX*X*X**X**X*****X*X****X*X*X*X*****X*X*****X**X***X*XXXXXXXX**XX***X*
*X***XX***X*X***X*X*X****X**X***X*X**X*XX**XXX**X*XXX*XX***XX*X*X*X***X*X**XXX*XX******X****X**XX***
*X*X****X**X*XX*X**X**X*X**X*XX***********X***X*X******X*****XX*X**X*X***X*****X**XXXX***XXX*X***XX*
*XX*XX*X*X*****X*X**X*X***X****XXX**XXX*XXXX*X**X*XXX*XX**XX*X**XX**X**X*XXX*XX**XX***X********XX***
******X***XXXX*X**X****XXX**XX*X**X****X**X**X*X*X***X***X*X**X***X***X*****X***X***X*XX**X*XXXXX*XX
XX**X**XX****X**X****X*X*XX**X***X*XXX**X***XX*X***X***XX***X*X*X*XXX*X***X*X*XX**X**X***XX****X**X*
***XXX**XX*X***X**X*XX*X***X**XX***X**X**X*X***X*XX*XXX***XX**X**X***X**XX**X***X**X*X*XX**XXX***XX*
*X**X*X**X**X*XX*XXX****XX*X*X**XX***X*X***X*X*X**X*X*X*XXX**X**X**X*X*X*X*X*X*X**XXX****X****X*X***
*XX****X*XX**X****XX*XX******XX***XX****XX**X*****X*****X***X**XX*XX***X*******X*XXX**XX*X*XX**X*X*X
***XX*X***XX*X*XXX****X*XXXXX***XX*XXX*XX*X*X*X***X*XX*XX*XX*XXX**X*XXX*X*X**XX**XX**X*X*XX*X*X****X
*X**X***X****X*****XX***X*****X***********X****X*X***X***********X***********XXX****X***********XX**