*XXXXXX**XXX*****XXX
*****XX***XX*XXX*XXX
XXX*XXX*X*XX*XXX*XXX
*X**XX**X****XX****X
*******XXXX*XXX*XXXX
XXXX*X******XXX*****