*****XX****X********XXXX
XX******XX***XXXXX***XXX
XX***XXXX**XXXXX****XXXX
XX***XXXXXXXXXXXXXX****X
*****XXXXXX****XX***XXXX
XX*************XXXX*****
*****XX****X*******XXXXX
XX******XX***XXXXX***XXX
XX***XXXX**XXXXX****XXXX
XX***XXXXXXXXXXXXXX****X
*****XXXXXX****XX**XXXXX
XX*************XX*******