*****XX****X********XXXX
XXXX****XX***XXXXXX*XXXX
XX**XXXXX*XXXXX***X*XXXX
XX***XXXXXXXXXXXXXX*X**X
*****XXXXXX****XX*X*XXXX
XX*************XXXX*****